libsipwitch-dev - secure peer-to-peer SIP VoIP server - development files
libsipwitch1 - secure peer-to-peer SIP VoIP server - development files
libsipwitch1-dbg - secure peer-to-peer SIP VoIP server - development files
sipwitch - secure peer-to-peer VoIP server for the SIP protocol
sipwitch-cgi - secure peer-to-peer SIP VoIP server - CGI XML-RPC interface
freeswitch - Cross-Platform Scalable Multi-Protocol Soft Switch
freeswitch-all - Cross-Platform Scalable Multi-Protocol Soft Switch
freeswitch-all-dbg - debugging symbols for FreeSWITCH
freeswitch-conf-curl - FreeSWITCH curl configuration
freeswitch-conf-insideout - FreeSWITCH insideout configuration
freeswitch-conf-rayo - FreeSWITCH rayo configuration
freeswitch-conf-sbc - FreeSWITCH sbc configuration
freeswitch-conf-softphone - FreeSWITCH softphone configuration
freeswitch-conf-vanilla - FreeSWITCH vanilla configuration
freeswitch-dbg - debugging symbols for FreeSWITCH
freeswitch-doc - documentation for FreeSWITCH
freeswitch-init - FreeSWITCH startup configuration
freeswitch-lang - Language files for FreeSWITCH
freeswitch-lang-de - German language files for FreeSWITCH
freeswitch-lang-en - English language files for FreeSWITCH
freeswitch-lang-es - Spanish language files for FreeSWITCH
freeswitch-lang-fr - French language files for FreeSWITCH
freeswitch-lang-he - Hebrew language files for FreeSWITCH
freeswitch-lang-pt - Portuguese language files for FreeSWITCH
freeswitch-lang-ru - Russian language files for FreeSWITCH
freeswitch-meta-all - Cross-Platform Scalable Multi-Protocol Soft Switch
freeswitch-meta-bare - Cross-Platform Scalable Multi-Protocol Soft Switch
freeswitch-meta-codecs - Cross-Platform Scalable Multi-Protocol Soft Switch
freeswitch-meta-conf - Cross-Platform Scalable Multi-Protocol Soft Switch
freeswitch-meta-default - Cross-Platform Scalable Multi-Protocol Soft Switch
freeswitch-meta-lang - Cross-Platform Scalable Multi-Protocol Soft Switch
freeswitch-meta-mod-say - Cross-Platform Scalable Multi-Protocol Soft Switch
freeswitch-meta-sorbet - Cross-Platform Scalable Multi-Protocol Soft Switch
freeswitch-meta-vanilla - Cross-Platform Scalable Multi-Protocol Soft Switch
freeswitch-mod-abstraction - Abstraction layer for APIs for FreeSWITCH
freeswitch-mod-abstraction-dbg - Abstraction layer for APIs for FreeSWITCH (debug)
freeswitch-mod-alsa - mod_alsa for FreeSWITCH
freeswitch-mod-alsa-dbg - mod_alsa for FreeSWITCH (debug)
freeswitch-mod-amr - mod_amr for FreeSWITCH
freeswitch-mod-amr-dbg - mod_amr for FreeSWITCH (debug)
freeswitch-mod-amrwb - mod_amrwb for FreeSWITCH
freeswitch-mod-amrwb-dbg - mod_amrwb for FreeSWITCH (debug)
freeswitch-mod-avmd - Advanced voicemail detection for FreeSWITCH
freeswitch-mod-avmd-dbg - Advanced voicemail detection for FreeSWITCH (debug)
freeswitch-mod-b64 - mod_b64 for FreeSWITCH
freeswitch-mod-b64-dbg - mod_b64 for FreeSWITCH (debug)
freeswitch-mod-blacklist - Blacklist helper for FreeSWITCH
freeswitch-mod-blacklist-dbg - Blacklist helper for FreeSWITCH (debug)
freeswitch-mod-bv - mod_bv for FreeSWITCH
freeswitch-mod-bv-dbg - mod_bv for FreeSWITCH (debug)
freeswitch-mod-callcenter - Call center for FreeSWITCH
freeswitch-mod-callcenter-dbg - Call center for FreeSWITCH (debug)
freeswitch-mod-cdr-csv - mod_cdr_csv for FreeSWITCH
freeswitch-mod-cdr-csv-dbg - mod_cdr_csv for FreeSWITCH (debug)
freeswitch-mod-cdr-mongodb - mod_cdr_mongodb for FreeSWITCH
freeswitch-mod-cdr-mongodb-dbg - mod_cdr_mongodb for FreeSWITCH (debug)
freeswitch-mod-cdr-pg-csv - mod_cdr_pg_csv for FreeSWITCH
freeswitch-mod-cdr-pg-csv-dbg - mod_cdr_pg_csv for FreeSWITCH (debug)
freeswitch-mod-cdr-sqlite - mod_cdr_sqlite for FreeSWITCH
freeswitch-mod-cdr-sqlite-dbg - mod_cdr_sqlite for FreeSWITCH (debug)
freeswitch-mod-celt - mod_celt for FreeSWITCH
freeswitch-mod-celt-dbg - mod_celt for FreeSWITCH (debug)
freeswitch-mod-cidlookup - Caller ID name lookup for FreeSWITCH
freeswitch-mod-cidlookup-dbg - Caller ID name lookup for FreeSWITCH (debug)
freeswitch-mod-cluechoo - Clue Choo for FreeSWITCH
freeswitch-mod-cluechoo-dbg - Clue Choo for FreeSWITCH (debug)
freeswitch-mod-codec2 - mod_codec2 for FreeSWITCH
freeswitch-mod-codec2-dbg - mod_codec2 for FreeSWITCH (debug)
freeswitch-mod-commands - Command module for FreeSWITCH
freeswitch-mod-commands-dbg - Command module for FreeSWITCH (debug)
freeswitch-mod-conference - Conference for FreeSWITCH
freeswitch-mod-conference-dbg - Conference for FreeSWITCH (debug)
freeswitch-mod-console - mod_console for FreeSWITCH
freeswitch-mod-console-dbg - mod_console for FreeSWITCH (debug)
freeswitch-mod-curl - cURL for FreeSWITCH
freeswitch-mod-curl-dbg - cURL for FreeSWITCH (debug)
freeswitch-mod-dahdi-codec - mod_dahdi_codec for FreeSWITCH
freeswitch-mod-dahdi-codec-dbg - mod_dahdi_codec for FreeSWITCH (debug)
freeswitch-mod-db - DB for FreeSWITCH
freeswitch-mod-db-dbg - DB for FreeSWITCH (debug)
freeswitch-mod-dialplan-asterisk - mod_dialplan_asterisk for FreeSWITCH
freeswitch-mod-dialplan-asterisk-dbg - mod_dialplan_asterisk for FreeSWITCH (debug)
freeswitch-mod-dialplan-directory - mod_dialplan_directory for FreeSWITCH
freeswitch-mod-dialplan-directory-dbg - mod_dialplan_directory for FreeSWITCH (debug)
freeswitch-mod-dialplan-xml - mod_dialplan_xml for FreeSWITCH
freeswitch-mod-dialplan-xml-dbg - mod_dialplan_xml for FreeSWITCH (debug)
freeswitch-mod-dingaling - mod_dingaling for FreeSWITCH
freeswitch-mod-dingaling-dbg - mod_dingaling for FreeSWITCH (debug)
freeswitch-mod-directory - Dial by name directory for FreeSWITCH
freeswitch-mod-directory-dbg - Dial by name directory for FreeSWITCH (debug)
freeswitch-mod-distributor - Load distributor for FreeSWITCH
freeswitch-mod-distributor-dbg - Load distributor for FreeSWITCH (debug)
freeswitch-mod-dptools - Dialplan tools for FreeSWITCH
freeswitch-mod-dptools-dbg - Dialplan tools for FreeSWITCH (debug)
freeswitch-mod-easyroute - Easyroute for FreeSWITCH
freeswitch-mod-easyroute-dbg - Easyroute for FreeSWITCH (debug)
freeswitch-mod-enum - ENUM for FreeSWITCH
freeswitch-mod-enum-dbg - ENUM for FreeSWITCH (debug)
freeswitch-mod-erlang-event - mod_erlang_event for FreeSWITCH
freeswitch-mod-erlang-event-dbg - mod_erlang_event for FreeSWITCH (debug)
freeswitch-mod-esf - Multicast support for FreeSWITCH
freeswitch-mod-esf-dbg - Multicast support for FreeSWITCH (debug)
freeswitch-mod-esl - Single ESL for FreeSWITCH
freeswitch-mod-esl-dbg - Single ESL for FreeSWITCH (debug)
freeswitch-mod-event-multicast - mod_event_multicast for FreeSWITCH
freeswitch-mod-event-multicast-dbg - mod_event_multicast for FreeSWITCH (debug)
freeswitch-mod-event-socket - mod_event_socket for FreeSWITCH
freeswitch-mod-event-socket-dbg - mod_event_socket for FreeSWITCH (debug)
freeswitch-mod-event-test - mod_event_test for FreeSWITCH
freeswitch-mod-event-test-dbg - mod_event_test for FreeSWITCH (debug)
freeswitch-mod-event-zmq - mod_event_zmq for FreeSWITCH
freeswitch-mod-event-zmq-dbg - mod_event_zmq for FreeSWITCH (debug)
freeswitch-mod-expr - Expr for FreeSWITCH
freeswitch-mod-expr-dbg - Expr for FreeSWITCH (debug)
freeswitch-mod-fifo - FIFO for FreeSWITCH
freeswitch-mod-fifo-dbg - FIFO for FreeSWITCH (debug)
freeswitch-mod-flite - mod_flite for FreeSWITCH
freeswitch-mod-flite-dbg - mod_flite for FreeSWITCH (debug)
freeswitch-mod-format-cdr - mod_format_cdr for FreeSWITCH
freeswitch-mod-format-cdr-dbg - mod_format_cdr for FreeSWITCH (debug)
freeswitch-mod-fsk - Frequency-shift keying for FreeSWITCH
freeswitch-mod-fsk-dbg - Frequency-shift keying for FreeSWITCH (debug)
freeswitch-mod-fsv - FSV for FreeSWITCH
freeswitch-mod-fsv-dbg - FSV for FreeSWITCH (debug)
freeswitch-mod-g723-1 - mod_g723_1 for FreeSWITCH
freeswitch-mod-g723-1-dbg - mod_g723_1 for FreeSWITCH (debug)
freeswitch-mod-g729 - mod_g729 for FreeSWITCH
freeswitch-mod-g729-dbg - mod_g729 for FreeSWITCH (debug)
freeswitch-mod-h26x - mod_h26x for FreeSWITCH
freeswitch-mod-h26x-dbg - mod_h26x for FreeSWITCH (debug)
freeswitch-mod-hash - Hash for FreeSWITCH
freeswitch-mod-hash-dbg - Hash for FreeSWITCH (debug)
freeswitch-mod-httapi - HT-TAPI Hypertext Telephony API for FreeSWITCH
freeswitch-mod-httapi-dbg - HT-TAPI Hypertext Telephony API for FreeSWITCH (debug)
freeswitch-mod-http-cache - HTTP GET with caching for FreeSWITCH
freeswitch-mod-http-cache-dbg - HTTP GET with caching for FreeSWITCH (debug)
freeswitch-mod-isac - mod_isac for FreeSWITCH
freeswitch-mod-isac-dbg - mod_isac for FreeSWITCH (debug)
freeswitch-mod-java - mod_java for FreeSWITCH
freeswitch-mod-java-dbg - mod_java for FreeSWITCH (debug)
freeswitch-mod-json-cdr - mod_json_cdr for FreeSWITCH
freeswitch-mod-json-cdr-dbg - mod_json_cdr for FreeSWITCH (debug)
freeswitch-mod-ladspa - LADSPA for FreeSWITCH
freeswitch-mod-ladspa-dbg - LADSPA for FreeSWITCH (debug)
freeswitch-mod-lcr - LCR for FreeSWITCH
freeswitch-mod-lcr-dbg - LCR for FreeSWITCH (debug)
freeswitch-mod-ldap - mod_ldap for FreeSWITCH
freeswitch-mod-ldap-dbg - mod_ldap for FreeSWITCH (debug)
freeswitch-mod-local-stream - mod_local_stream for FreeSWITCH
freeswitch-mod-local-stream-dbg - mod_local_stream for FreeSWITCH (debug)
freeswitch-mod-logfile - mod_logfile for FreeSWITCH
freeswitch-mod-logfile-dbg - mod_logfile for FreeSWITCH (debug)
freeswitch-mod-loopback - mod_loopback for FreeSWITCH
freeswitch-mod-loopback-dbg - mod_loopback for FreeSWITCH (debug)
freeswitch-mod-lua - mod_lua for FreeSWITCH
freeswitch-mod-lua-dbg - mod_lua for FreeSWITCH (debug)
freeswitch-mod-memcache - Memcache for FreeSWITCH
freeswitch-mod-memcache-dbg - Memcache for FreeSWITCH (debug)
freeswitch-mod-mp4v - mod_mp4v for FreeSWITCH
freeswitch-mod-mp4v-dbg - mod_mp4v for FreeSWITCH (debug)
freeswitch-mod-native-file - mod_native_file for FreeSWITCH
freeswitch-mod-native-file-dbg - mod_native_file for FreeSWITCH (debug)
freeswitch-mod-nibblebill - Nibblebill for FreeSWITCH
freeswitch-mod-nibblebill-dbg - Nibblebill for FreeSWITCH (debug)
freeswitch-mod-opus - mod_opus for FreeSWITCH
freeswitch-mod-opus-dbg - mod_opus for FreeSWITCH (debug)
freeswitch-mod-oreka - Media recording with Oreka for FreeSWITCH
freeswitch-mod-oreka-dbg - Media recording with Oreka for FreeSWITCH (debug)
freeswitch-mod-perl - mod_perl for FreeSWITCH
freeswitch-mod-perl-dbg - mod_perl for FreeSWITCH (debug)
freeswitch-mod-pocketsphinx - mod_pocketsphinx for FreeSWITCH
freeswitch-mod-pocketsphinx-dbg - mod_pocketsphinx for FreeSWITCH (debug)
freeswitch-mod-portaudio - mod_portaudio for FreeSWITCH
freeswitch-mod-portaudio-dbg - mod_portaudio for FreeSWITCH (debug)
freeswitch-mod-portaudio-stream - mod_portaudio_stream for FreeSWITCH
freeswitch-mod-portaudio-stream-dbg - mod_portaudio_stream for FreeSWITCH (debug)
freeswitch-mod-posix-timer - mod_posix_timer for FreeSWITCH
freeswitch-mod-posix-timer-dbg - mod_posix_timer for FreeSWITCH (debug)
freeswitch-mod-python - mod_python for FreeSWITCH
freeswitch-mod-python-dbg - mod_python for FreeSWITCH (debug)
freeswitch-mod-radius-cdr - mod_radius_cdr for FreeSWITCH
freeswitch-mod-radius-cdr-dbg - mod_radius_cdr for FreeSWITCH (debug)
freeswitch-mod-random - Entropy extraction for FreeSWITCH
freeswitch-mod-random-dbg - Entropy extraction for FreeSWITCH (debug)
freeswitch-mod-rayo - mod_rayo for FreeSWITCH
freeswitch-mod-rayo-dbg - mod_rayo for FreeSWITCH (debug)
freeswitch-mod-redis - Redis limit backend for FreeSWITCH
freeswitch-mod-redis-dbg - Redis limit backend for FreeSWITCH (debug)
freeswitch-mod-rss - RSS browser for FreeSWITCH
freeswitch-mod-rss-dbg - RSS browser for FreeSWITCH (debug)
freeswitch-mod-rtmp - mod_rtmp for FreeSWITCH
freeswitch-mod-rtmp-dbg - mod_rtmp for FreeSWITCH (debug)
freeswitch-mod-say-de - mod_say_de for FreeSWITCH
freeswitch-mod-say-de-dbg - mod_say_de for FreeSWITCH (debug)
freeswitch-mod-say-en - mod_say_en for FreeSWITCH
freeswitch-mod-say-en-dbg - mod_say_en for FreeSWITCH (debug)
freeswitch-mod-say-es - mod_say_es for FreeSWITCH
freeswitch-mod-say-es-dbg - mod_say_es for FreeSWITCH (debug)
freeswitch-mod-say-fa - mod_say_fa for FreeSWITCH
freeswitch-mod-say-fa-dbg - mod_say_fa for FreeSWITCH (debug)
freeswitch-mod-say-fr - mod_say_fr for FreeSWITCH
freeswitch-mod-say-fr-dbg - mod_say_fr for FreeSWITCH (debug)
freeswitch-mod-say-he - mod_say_he for FreeSWITCH
freeswitch-mod-say-he-dbg - mod_say_he for FreeSWITCH (debug)
freeswitch-mod-say-hr - mod_say_hr for FreeSWITCH
freeswitch-mod-say-hr-dbg - mod_say_hr for FreeSWITCH (debug)
freeswitch-mod-say-hu - mod_say_hu for FreeSWITCH
freeswitch-mod-say-hu-dbg - mod_say_hu for FreeSWITCH (debug)
freeswitch-mod-say-it - mod_say_it for FreeSWITCH
freeswitch-mod-say-it-dbg - mod_say_it for FreeSWITCH (debug)
freeswitch-mod-say-ja - mod_say_ja for FreeSWITCH
freeswitch-mod-say-ja-dbg - mod_say_ja for FreeSWITCH (debug)
freeswitch-mod-say-nl - mod_say_nl for FreeSWITCH
freeswitch-mod-say-nl-dbg - mod_say_nl for FreeSWITCH (debug)
freeswitch-mod-say-pl - mod_say_pl for FreeSWITCH
freeswitch-mod-say-pl-dbg - mod_say_pl for FreeSWITCH (debug)
freeswitch-mod-say-pt - mod_say_pt for FreeSWITCH
freeswitch-mod-say-pt-dbg - mod_say_pt for FreeSWITCH (debug)
freeswitch-mod-say-ru - mod_say_ru for FreeSWITCH
freeswitch-mod-say-ru-dbg - mod_say_ru for FreeSWITCH (debug)
freeswitch-mod-say-th - mod_say_th for FreeSWITCH
freeswitch-mod-say-th-dbg - mod_say_th for FreeSWITCH (debug)
freeswitch-mod-say-zh - mod_say_zh for FreeSWITCH
freeswitch-mod-say-zh-dbg - mod_say_zh for FreeSWITCH (debug)
freeswitch-mod-shell-stream - mod_shell_stream for FreeSWITCH
freeswitch-mod-shell-stream-dbg - mod_shell_stream for FreeSWITCH (debug)
freeswitch-mod-silk - mod_silk for FreeSWITCH
freeswitch-mod-silk-dbg - mod_silk for FreeSWITCH (debug)
freeswitch-mod-skinny - mod_skinny for FreeSWITCH
freeswitch-mod-skinny-dbg - mod_skinny for FreeSWITCH (debug)
freeswitch-mod-skypopen - mod_skypopen for FreeSWITCH
freeswitch-mod-skypopen-dbg - mod_skypopen for FreeSWITCH (debug)
freeswitch-mod-sms - Astract SMS for FreeSWITCH
freeswitch-mod-sms-dbg - Astract SMS for FreeSWITCH (debug)
freeswitch-mod-snapshot - Snapshot for FreeSWITCH
freeswitch-mod-snapshot-dbg - Snapshot for FreeSWITCH (debug)
freeswitch-mod-sndfile - mod_sndfile for FreeSWITCH
freeswitch-mod-sndfile-dbg - mod_sndfile for FreeSWITCH (debug)
freeswitch-mod-snipe-hunt - Snipe hunt for FreeSWITCH
freeswitch-mod-snipe-hunt-dbg - Snipe hunt for FreeSWITCH (debug)
freeswitch-mod-snmp - mod_snmp for FreeSWITCH
freeswitch-mod-snmp-dbg - mod_snmp for FreeSWITCH (debug)
freeswitch-mod-snom - SNOM specific features for FreeSWITCH
freeswitch-mod-snom-dbg - SNOM specific features for FreeSWITCH (debug)
freeswitch-mod-sofia - mod_sofia for FreeSWITCH
freeswitch-mod-sofia-dbg - mod_sofia for FreeSWITCH (debug)
freeswitch-mod-sonar - Sonar ping timer for FreeSWITCH
freeswitch-mod-sonar-dbg - Sonar ping timer for FreeSWITCH (debug)
freeswitch-mod-soundtouch - Soundtouch for FreeSWITCH
freeswitch-mod-soundtouch-dbg - Soundtouch for FreeSWITCH (debug)
freeswitch-mod-spandsp - SpanDSP for FreeSWITCH
freeswitch-mod-spandsp-dbg - SpanDSP for FreeSWITCH (debug)
freeswitch-mod-speex - mod_speex for FreeSWITCH
freeswitch-mod-speex-dbg - mod_speex for FreeSWITCH (debug)
freeswitch-mod-spy - UserSpy for FreeSWITCH
freeswitch-mod-spy-dbg - UserSpy for FreeSWITCH (debug)
freeswitch-mod-ssml - mod_ssml for FreeSWITCH
freeswitch-mod-ssml-dbg - mod_ssml for FreeSWITCH (debug)
freeswitch-mod-stress - Voice stress detection for FreeSWITCH
freeswitch-mod-stress-dbg - Voice stress detection for FreeSWITCH (debug)
freeswitch-mod-syslog - mod_syslog for FreeSWITCH
freeswitch-mod-syslog-dbg - mod_syslog for FreeSWITCH (debug)
freeswitch-mod-theora - mod_theora for FreeSWITCH
freeswitch-mod-theora-dbg - mod_theora for FreeSWITCH (debug)
freeswitch-mod-timerfd - mod_timerfd for FreeSWITCH
freeswitch-mod-timerfd-dbg - mod_timerfd for FreeSWITCH (debug)
freeswitch-mod-tone-stream - mod_tone_stream for FreeSWITCH
freeswitch-mod-tone-stream-dbg - mod_tone_stream for FreeSWITCH (debug)
freeswitch-mod-translate - Number translation for FreeSWITCH
freeswitch-mod-translate-dbg - Number translation for FreeSWITCH (debug)
freeswitch-mod-tts-commandline - mod_tts_commandline for FreeSWITCH
freeswitch-mod-tts-commandline-dbg - mod_tts_commandline for FreeSWITCH (debug)
freeswitch-mod-unimrcp - mod_unimrcp for FreeSWITCH
freeswitch-mod-unimrcp-dbg - mod_unimrcp for FreeSWITCH (debug)
freeswitch-mod-valet-parking - Valet parking for FreeSWITCH
freeswitch-mod-valet-parking-dbg - Valet parking for FreeSWITCH (debug)
freeswitch-mod-vlc - VLC streaming for FreeSWITCH
freeswitch-mod-vlc-dbg - VLC streaming for FreeSWITCH (debug)
freeswitch-mod-vmd - Voicemail detection for FreeSWITCH
freeswitch-mod-vmd-dbg - Voicemail detection for FreeSWITCH (debug)
freeswitch-mod-voicemail - Voicemail for FreeSWITCH
freeswitch-mod-voicemail-dbg - Voicemail for FreeSWITCH (debug)
freeswitch-mod-voicemail-ivr - Voicemail IVR for FreeSWITCH
freeswitch-mod-voicemail-ivr-dbg - Voicemail IVR for FreeSWITCH (debug)
freeswitch-mod-vp8 - VP8 video codec for FreeSWITCH
freeswitch-mod-vp8-dbg - VP8 video codec for FreeSWITCH (debug)
freeswitch-mod-xml-cdr - mod_xml_cdr for FreeSWITCH
freeswitch-mod-xml-cdr-dbg - mod_xml_cdr for FreeSWITCH (debug)
freeswitch-mod-xml-curl - mod_xml_curl for FreeSWITCH
freeswitch-mod-xml-curl-dbg - mod_xml_curl for FreeSWITCH (debug)
freeswitch-mod-xml-rpc - mod_xml_rpc for FreeSWITCH
freeswitch-mod-xml-rpc-dbg - mod_xml_rpc for FreeSWITCH (debug)
freeswitch-mod-xml-scgi - mod_xml_scgi for FreeSWITCH
freeswitch-mod-xml-scgi-dbg - mod_xml_scgi for FreeSWITCH (debug)
freeswitch-mod-yaml - mod_yaml for FreeSWITCH
freeswitch-mod-yaml-dbg - mod_yaml for FreeSWITCH (debug)
freeswitch-music - Music on hold audio for FreeSWITCH
freeswitch-music-default - Default music on hold sounds for FreeSWITCH
freeswitch-sounds - Sounds for FreeSWITCH
freeswitch-sounds-en - English sounds for FreeSWITCH
freeswitch-sounds-en-us - US English sounds for FreeSWITCH
freeswitch-sounds-en-us-callie - US English Callie sounds for FreeSWITCH
freeswitch-systemd - FreeSWITCH systemd configuration
freeswitch-sysvinit - FreeSWITCH SysV init script
fusionpbx - Fusionpbx: Web gui for controlling/administrating freeswitch softwitch
fusionpbx-dev - Fusionpbx: Web gui for controlling/administrating freeswitch softwitch
libfreeswitch-dev - development libraries and header files for FreeSWITCH
libfreeswitch1 - Cross-Platform Scalable Multi-Protocol Soft Switch
libfreeswitch1-dbg - debugging symbols for FreeSWITCH